ラテン文字	キリル文字
Šč	Щ
šč	щ
Shch	Щ
shch	щ
Č	Ч
č	ч
Ch	Ч
ch	ч
Š	Ш
š	ш
Sh	Ш
sh	ш
Ž	Ж
ž	ж
Zh	Ж
zh	ж
È	Э
è	э
Eh	Э
eh	э
Ja	Я
ja	я
Ju	Ю
ju	ю
Ë	Ё
ë	ё
Yo	Ё
yo	ё
A	А
a	а
E	Е
e	е
I	И
i	и
O	О
o	о
U	У
u	у
Y	Ы
y	ы
J	Й
j	й
S	С
s	с
Z	З
z	з
C	Ц
c	ц
P	П
p	п
B	Б
b	б
V	В
v	в
T	Т
t	т
D	Д
d	д
K	К
k	к
G	Г
g	г
X	Х
x	х
H	Х
h	х
L	Л
l	л
R	Р
r	р
M	М
m	м
N	Н
n	н
F	Ф
f	ф
ʺ	ъ
"	ъ
ʹ	ь
'	ь
