ラテン文字	キリル文字
%%%%%	# 句読点
--	*—
”	»
""	»
“	«
"	«
%%%%%	# アクセント記号
/	<｣<
q	<｣<
|｣||｣||｣|	
>｣>>｣>	*̀
>｣>	*́
*	
<	|
|	>
%%%%%	# 母音字
Ja	Я
ja	я
A	А
a	а
Je	Є
je	є
E	Е
e	е
Ji	Ї
ji	ї
I	І
i	і
Y	И
y	и
O	О
o	о
Ju	Ю
ju	ю
U	У
u	у
%%%%%	# 子音字
Šč	Щ
šč	щ
Shch	Щ
shch	щ	
Č	Ч
č	ч
Ch	Ч
ch	ч
Š	Ш
š	ш
Sh	Ш
sh	ш
Ž	Ж
ž	ж
Zq	Ж
zq	ж
B	Б
b	б
V	В
v	в
W	В
w	в
H	Г
h	г
G	Ґ
g	ґ
D	Д
d	д
Z	З
z	з
K	К
k	к
L	Л
l	л
M	М
m	м
N	Н
n	н
P	П
p	п
R	Р
r	р
S	С
s	с
T	Т
t	т
F	Ф
f	ф
X	Х
x	х
C	Ц
c	ц
ʹ	ь
jj	ь
ʺ	ʼ
'	ʼ
J	Й
j	й